# Gboard Dictionary version:1
_\infty	 ͚	
_∞	 ͚	
_inf	 ͚	
_infty	 ͚	
\vec0	0⃗	
\hatA	Â	
\barA	A̅	
\overlineA	A̅	
\vecA	A⃗	
\hatB	B̂	
\barB	B̅	
\overlineB	B̅	
\vecB	B⃗	
\barC	C̅	
\overlineC	C̅	
\barD	D̅	
\overlineD	D̅	
\dotD	Ḋ	
\barE	E̅	
\overlineE	E̅	
\vecE	E⃗	
E~	E⃗	
\barF	F̅	
\overlineF	F̅	
\vecF	F⃗	
F~	F⃗	
\barG	G̅	
\overlineG	G̅	
\hatH	Ĥ	
\barH	H̅	
\overlineH	H̅	
\dotH	Ḣ	
\Iota	I	
\barI	I̅	
\overlineI	I̅	
\hatJ	Ĵ	
\barJ	J̅	
\overlineJ	J̅	
\barK	K̅	
\overlineK	K̅	
\hatL	L̂	
\barL	L̅	
\overlineL	L̅	
\LaTeX	LᴬTᴇX	
\vecL	L⃗	
\barM	M̅	
\overlineM	M̅	
\dotM	Ṁ	
\barN	N̅	
\overlineN	N̅	
\hatO	Ô	
\barO	O̅	
\overlineO	O̅	
\barP	P̅	
\overlineP	P̅	
\barQ	Q̅	
\overlineQ	Q̅	
\barR	R̅	
\overlineR	R̅	
\dotR	Ṙ	
\vecR	R⃗	
\hatS	Ŝ	
\barS	S̅	
\overlineS	S̅	
\hatT	T̂	
\barT	T̅	
\overlineT	T̅	
\dotT	Ṫ	
\barU	U̅	
\overlineU	U̅	
\hatV	V̂	
\barV	V̅	
\overlineV	V̅	
\dotV	V̇	
\barW	W̅	
\overlineW	W̅	
\barX	X̅	
\overlineX	X̅	
\vecX	X⃗	
\barY	Y̅	
\overlineY	Y̅	
\barZ	Z̅	
\overlineZ	Z̅	
\bara	a̅	
\overlinea	a̅	
\dota	ȧ	
\veca	a⃗	
\barb	b̅	
\overlineb	b̅	
\vecb	b⃗	
\barc	c̅	
\overlinec	c̅	
\vecc	c⃗	
\dq	d/dx	
\bard	d̅	
\overlined	d̅	
\bare	e̅	
\overlinee	e̅	
\vece	e⃗	
\barf	f̅	
\overlinef	f̅	
\barg	g̅	
\overlineg	g̅	
\vecg	g⃗	
\barh	h̅	
\overlineh	h̅	
\hati	î	
\bari	i̅	
\overlinei	i̅	
\hatj	ĵ	
\barj	j̅	
\overlinej	j̅	
\vecj	j⃗	
\kB	kʙ	
\hatk	k̂	
\bark	k̅	
\overlinek	k̅	
\veck	k⃗	
\lim	lim_{x→} 	
\barl	l̅	
\overlinel	l̅	
\vecl	l⃗	
\barm	m̅	
\overlinem	m̅	
\vecm	m⃗	
\hatn	n̂	
\barn	n̅	
\overlinen	n̅	
\vecn	n⃗	
\baro	o̅	
\overlineo	o̅	
\hatp	p̂	
\barp	p̅	
\overlinep	p̅	
\dotp	ṗ	
\dotvecp	ṗ⃗	
\vecp	p⃗	
\barq	q̅	
\overlineq	q̅	
\dotq	q̇	
\ddotq	q̈	
\vecq	q⃗	
\hatr	r̂	
\barr	r̅	
\overliner	r̅	
\dotr	ṙ	
\ddotr	r̈	
\vecr	r⃗	
~r	r⃗ 	
\dotvecr	r⃗̇	
\ddotvecr	r⃗̈	
\bars	s̅	
\overlines	s̅	
\vecs	s⃗	
\bart	t̅	
\overlinet	t̅	
\baru	u̅	
\overlineu	u̅	
\barv	v̅	
\overlinev	v̅	
\dotv	v̇	
\vecv	v⃗	
\barw	w̅	
\overlinew	w̅	
\hatx	x̂	
\barx	x̅	
\overlinex	x̅	
\dotx	ẋ	
\ddotx	ẍ	
\vecx	x⃗	
~x	x⃗	
\dot\vecx	x⃗̇	
\ddot\vecx	x⃗̈	
\vecy	y	
\bary	y̅	
\overliney	y̅	
\doty	ẏ	
\ddoty	ÿ	
\vecy	y⃗	
\barz	z̅	
\overlinez	z̅	
\dotz	ż	
\ddotz	z̈	
\vecz	z⃗	
\ket	|⋅⟩	
\sec	§	
\lnot	¬	
\neg	¬	
\pm	±	
^2	²	
^3	³	
^1	¹	
\times	×	
\ddota	ä	
\div	÷	
_G	ɢ	
_I	ɪ	
_N	ɴ	
_R	ʀ	
_Y	ʏ	
_B	ʙ	
_H	ʜ	
_L	ʟ	
^h	ʰ	
^j	ʲ	
^r	ʳ	
^w	ʷ	
^y	ʸ	
^Y	ʸ	
^l	ˡ	
^s	ˢ	
^S	ˢ	
^x	ˣ	
^X	ˣ	
^hat	̂	
^bar	̅	
^overline	̅	
\Alpha	Α	
\Beta	Β	
\Gamma	Γ	
\Delta	Δ	
\Epsilon	Ε	
\Zeta	Ζ	
\Eta	Η	
\Theta	Θ	
\Kappa	Κ	
\Lambda	Λ	
\Mu	Μ	
\Nu	Ν	
\Xi	Ξ	
\Omicron	Ο	
\Pi	Π	
\Rho	Ρ	
\Sigma	Σ	
\Tau	Τ	
\Upsilon	Υ	
\Phi	Φ	
\Chi	Χ	
\Psi	Ψ	
\Omega	Ω	
\alpha	α	
\beta	β	
\gamma	γ	
\delta	δ	
\epsilon	ε	
\varepsilon	ε	
\electric	ε₀	
\zeta	ζ	
\eta	η	
\theta	θ	
\dot\theta	θ̇	
\iota	ι	
\kappa	κ	
\lambda	λ	
\mu	μ	
\magnetic	μ₀	
\nu	ν	
\xi	ξ	
\omicron	ο	
\pi	π	
\rho	ρ	
\varsigma	ς	
\sigma	σ	
\vecsigma	σ⃗	
~σ	σ⃗ 	
\tau	τ	
\vectau	τ⃗	
\upsilon	υ	
\phi	φ	
\varphi	φ	
\dotvarphi	φ̇	
\chi	χ	
\psi	ψ	
\omega	ω	
\vecomega	ω⃗	
~ω	ω⃗	
\vartheta	ϑ	
\dot\vartheta	ϑ̇	
\phi	ϕ	
\varpi	ϖ	
\varkappa	ϰ	
\varrho	ϱ	
\epsilon	ϵ	
^\inf	᪲	
^\infty	᪲	
^∞	᪲	
^inf	᪲	
^infty	᪲	
_A	ᴀ	
_C	ᴄ	
_D	ᴅ	
_E	ᴇ	
_J	ᴊ	
_K	ᴋ	
_M	ᴍ	
_O	ᴏ	
_P	ᴘ	
_T	ᴛ	
_U	ᴜ	
_V	ᴠ	
_W	ᴡ	
_Z	ᴢ	
^A	ᴬ	
^B	ᴮ	
^D	ᴰ	
^E	ᴱ	
^G	ᴳ	
^H	ᴴ	
^I	ᴵ	
^J	ᴶ	
^K	ᴷ	
^L	ᴸ	
^M	ᴹ	
^N	ᴺ	
^O	ᴼ	
^P	ᴾ	
^R	ᴿ	
^T	ᵀ	
^U	ᵁ	
^W	ᵂ	
^a	ᵃ	
^b	ᵇ	
^d	ᵈ	
^e	ᵉ	
^g	ᵍ	
^k	ᵏ	
^m	ᵐ	
^o	ᵒ	
^p	ᵖ	
^t	ᵗ	
^u	ᵘ	
^v	ᵛ	
^q	ᵠ	
^Q	ᵠ	
_i	ᵢ	
_r	ᵣ	
_u	ᵤ	
_v	ᵥ	
_\beta	ᵦ	
_beta	ᵦ	
_β	ᵦ	
_b	ᵦ	
_\gamma	ᵧ	
_gamma	ᵧ	
_γ	ᵧ	
_y	ᵧ	
_\rho	ᵨ	
_rho	ᵨ	
_ρ	ᵨ	
_\phi	ᵩ	
_phi	ᵩ	
_ϕ	ᵩ	
_q	ᵩ	
_\chi	ᵪ	
_chi	ᵪ	
_χ	ᵪ	
^c	ᶜ	
^C	ᶜ	
^f	ᶠ	
^F	ᶠ	
^z	ᶻ	
^Z	ᶻ	
\|	‖	
\norm	‖⋅‖	
\prime	′	
\dprime	″	
^0	⁰	
^i	ⁱ	
^4	⁴	
^5	⁵	
^6	⁶	
^7	⁷	
^8	⁸	
^9	⁹	
^+	⁺	
^-	⁻	
^=	⁼	
^(	⁽	
^)	⁾	
^n	ⁿ	
_0	₀	
_1	₁	
_2	₂	
_3	₃	
_4	₄	
_5	₅	
_6	₆	
_7	₇	
_8	₈	
_9	₉	
_+	₊	
_-	₋	
_=	₌	
_(	₍	
_)	₎	
_a	ₐ	
_e	ₑ	
_o	ₒ	
_x	ₓ	
_h	ₕ	
_k	ₖ	
_l	ₗ	
_m	ₘ	
_n	ₙ	
_p	ₚ	
_s	ₛ	
_t	ₜ	
^\rightarrow	⃗	
^rightarrow	⃗	
^\to	⃗	
^to	⃗	
^→	⃗	
\complex	ℂ	
\mathbbC	ℂ	
\C	ℂ	
\mathfrakH	ℌ	
\mathbbH	ℍ	
h	ℎ	
hbar	ℏ	
\Im	ℑ	
\mathfrakI	ℑ	
\natural	ℕ	
\N	ℕ	
\mathbbN	ℕ	
\wp	℘	
\mathbbP	ℙ	
\rational	ℚ	
\mathbbQ	ℚ	
\Q	ℚ	
\Re	ℜ	
\mathfrakR	ℜ	
\real	ℝ	
\R	ℝ	
\mathbbR	ℝ	
\integer	ℤ	
\Z	ℤ	
\mathbbZ	ℤ	
\mathfrakZ	ℨ	
\mathfrakC	ℭ	
\aleph	ℵ	
\beth	ℶ	
\roman1	Ⅰ	
\roman2	Ⅱ	
\roman3	Ⅲ	
\leftarrow	←	
\uparrow	↑	
\rightarrow	→	
\to	→	
\downarrow	↓	
\leftrightarrow	↔	
\nwarrow	↖	
\nearrow	↗	
\searrow	↘	
\swarrow	↙	
\twoheadleftarrow	↞	
\twoheadrightarrow	↠	
\leftarrowtail	↢	
\rightarrowtail	↣	
\mapsto	↦	
\hookleftarrow	↩	
\hookrightarrow	↪	
\rightharpoonup	⇀	
\rightharpoondown	⇁	
\leftrightharpoons	⇋	
\rightleftharpoons	⇌	
\Leftarrow	⇐	
\not\Leftarrow	⇍	
\Uparrow	⇑	
\Rightarrow	⇒	
=>	⇒	
\implies	⇒	
\not\Rightarrow	⇏	
\Downarrow	⇓	
\Leftrightarrow	⇔	
equiv	⇔	
\rightsquigarrow	⇝	
\forall	∀	
\partial	∂	
\dpartq	∂/∂x	
\exists	∃	
\nexists	∄	
\not\exists	∄	
\emptyset	∅	
\nabla	∇	
\in	∈	
\notin	∉	
\not\in	∉	
\ni	∋	
\not\ni	∌	
\qed	∎	
\prod	∏	
\coprod	∐	
\sum	∑	
\sumk	∑ₖ₌₀ⁿ 	
\suminf	∑ₙ₌₀ ᪲	
-	−	
\mp	∓	
\dotplus	∔	
\setminus	∖	
\circ	∘	
\bullet	∙	
\surd	√	
\sqrt	√	
^3\sqrt	∛	
\cuberoot	∛	
\3root	∛	
^4\sqrt	∜	
\fourthroot	∜	
\4root	∜	
\propto	∝	
\inf	∞	
\infty	∞	
_\inf	∞	
\angle	∠	
\measuredangle	∡	
\sphericalangle	∢	
\mid	∣	
\nmid	∤	
\not\mid	∤	
\parallel	∥	
\nparallel	∦	
\not\parallel	∦	
\land	∧	
\wedge	∧	
\lor	∨	
\vee	∨	
\cap	∩	
\cup	∪	
\integral	∫	
\int	∫	
\int0inf	∫₀ ᪲	
\intinf	∫₋  ͚ ᪲	
\intinf0	∫₋  ͚⁰	
\iint	∬	
\iiint	∭	
\oint	∮	
\surfintegral	∯	
\oiint	∯	
\volintegral	∰	
\oiiint	∰	
\intclockwise	∱	
\varointclockwise	∲	
\ointctrclockwise	∳	
\therefore	∴	
\because	∵	
\sim	∼	
\backsim	∽	
\lazysinv	∾	
\wr	≀	
\not\sim	≁	
\simeq	≃	
\not\simeq	≄	
\cong	≅	
\approxnotequal	≆	
\not\cong	≇	
\approx	≈	
\approxeq	≊	
\tildetrpl	≋	
\allequal	≌	
\asymp	≍	
\doteq	≐	
\doteqdot	≑	
\coloneqq	≔	
\eqqcolon	≕	
\neq	≠	
\equivalent	≡	
\equiv	≡	
\not\equiv	≢	
\Equiv	≣	
\leq	≤	
\geq	≥	
\leqq	≦	
\geqq	≧	
\lneqq	≨	
\gneqq	≩	
\ll	≪	
\gg	≫	
\nless	≮	
\ngtr	≯	
\nleq	≰	
\ngeq	≱	
\lessequivlnt	≲	
\greaterequivlnt	≳	
\prec	≺	
\succ	≻	
\preccurlyeq	≼	
\succcurlyeq	≽	
\precapprox	≾	
\succapprox	≿	
\nprec	⊀	
\nsucc	⊁	
\subset	⊂	
\supset	⊃	
\not\subset	⊄	
\not\supset	⊅	
\subseteq	⊆	
\supseteq	⊇	
\nsubseteq	⊈	
\not\subseteq	⊈	
\nsupseteq	⊉	
\not\supseteq	⊉	
\subsetneq	⊊	
\supsetneq	⊋	
\dot\cup	⊍	
\xor	⊕	
\oplus	⊕	
\ominus	⊖	
\otimes	⊗	
\oslash	⊘	
\odot	⊙	
\vdash	⊢	
\top	⊤	
\bot	⊥	
\models	⊨	
\veebar	⊻	
\bigcap	⋂	
\bigcup	⋃	
\cdot	⋅	
\vdots	⋮	
\cdots	⋯	
\iddots	⋰	
\ddots	⋱	
\lceil	⌈	
\rceil	⌉	
\lfloor	⌊	
\rfloor	⌋	
\Box	□	
\earth	♁	
\flat	♭	
\natural	♮	
\sharp	♯	
\perp	⟂	
\langle	⟨	
\inner	⟨⋅,⋅⟩	
\bra	⟨⋅|	
\braket	⟨⋅|⋅⟩	
\expect	⟨⋅⟩	
\rangle	⟩	
_\Leftarrow	⟸	
_\Rightarrow	⟹	
_\Leftrightarrow	⟺	
\iiiint	⨌	
\intctrclockwise	⨑	
\leqslant	⩽	
\geqslant	⩾	
\lneq	⪇	
\gneq	⪈	
\preceq	⪯	
\succeq	⪰	
\precneqq	⪵	
\succneqq	⪶	
_j	ⱼ	
^V	ⱽ	
^excl	ꜝ	
_F	ꜰ	
_S	ꜱ	
\mvdots	︙	
\scriptB	𝐵	
\mathscrB	𝐵	
\scriptE	𝐸	
\mathscrE	𝐸	
\scriptF	𝐹	
\mathscrF	𝐹	
\scriptH	𝐻	
\mathscrH	𝐻	
\scriptI	𝐼	
\mathscrI	𝐼	
\scriptL	𝐿	
\mathscrL	𝐿	
\L	𝐿	
\scriptM	𝑀	
\mathscrM	𝑀	
\scriptR	𝑅	
\mathscrR	𝑅	
\scripte	𝑒	
\mathscre	𝑒	
\scriptg	𝑔	
\mathscrg	𝑔	
\scripto	𝑜	
\mathscro	𝑜	
\scriptA	𝒜	
\mathscrA	𝒜	
\scriptC	𝒞	
\mathscrC	𝒞	
\scriptD	𝒟	
\mathscrD	𝒟	
\scriptG	𝒢	
\mathscrG	𝒢	
\scriptJ	𝒥	
\mathscrJ	𝒥	
\scriptK	𝒦	
\mathscrK	𝒦	
\scriptN	𝒩	
\mathscrN	𝒩	
\scriptO	𝒪	
\mathscrO	𝒪	
\scriptP	𝒫	
\mathscrP	𝒫	
\scriptQ	𝒬	
\mathscrQ	𝒬	
\scriptS	𝒮	
\mathscrS	𝒮	
\scriptT	𝒯	
\mathscrT	𝒯	
\scriptU	𝒰	
\mathscrU	𝒰	
\scriptV	𝒱	
\mathscrV	𝒱	
\scriptW	𝒲	
\mathscrW	𝒲	
\scriptX	𝒳	
\mathscrX	𝒳	
\scriptY	𝒴	
\mathscrY	𝒴	
\scriptZ	𝒵	
\mathscrZ	𝒵	
\scripta	𝒶	
\mathscra	𝒶	
\scriptb	𝒷	
\mathscrb	𝒷	
_c	𝒸	
\scriptc	𝒸	
\mathscrc	𝒸	
_d	𝒹	
\scriptd	𝒹	
\mathscrd	𝒹	
_f	𝒻	
\scriptf	𝒻	
\mathscrf	𝒻	
\scripth	𝒽	
\mathscrh	𝒽	
\scripti	𝒾	
\mathscri	𝒾	
\scriptj	𝒿	
\mathscrj	𝒿	
\scriptk	𝓀	
\mathscrk	𝓀	
\scriptl	𝓁	
\mathscrl	𝓁	
\scriptm	𝓂	
\mathscrm	𝓂	
\scriptn	𝓃	
\mathscrn	𝓃	
\scriptp	𝓅	
\mathscrp	𝓅	
\scriptq	𝓆	
\mathscrq	𝓆	
\scriptr	𝓇	
\mathscrr	𝓇	
\scripts	𝓈	
\mathscrs	𝓈	
\scriptt	𝓉	
\mathscrt	𝓉	
\scriptu	𝓊	
\mathscru	𝓊	
\scriptv	𝓋	
\mathscrv	𝓋	
_w	𝓌	
\scriptw	𝓌	
\mathscrw	𝓌	
\scriptx	𝓍	
\mathscrx	𝓍	
\scripty	𝓎	
\mathscry	𝓎	
_z	𝓏	
\scriptz	𝓏	
\mathscrz	𝓏	
_g	𝓰	
\mathfrakA	𝔄	
\mathfrakB	𝔅	
\mathfrakD	𝔇	
\mathfrakE	𝔈	
\mathfrakF	𝔉	
\mathfrakG	𝔊	
\mathfrakJ	𝔍	
\mathfrakK	𝔎	
\mathfrakL	𝔏	
\mathfrakM	𝔐	
\mathfrakN	𝔑	
\mathfrakO	𝔒	
\mathfrakP	𝔓	
\mathfrakQ	𝔔	
\mathfrakS	𝔖	
\mathfrakT	𝔗	
\mathfrakU	𝔘	
\mathfrakV	𝔙	
\mathfrakW	𝔚	
\mathfrakX	𝔛	
\mathfrakY	𝔜	
\mathfraka	𝔞	
\mathfrakb	𝔟	
\mathfrakc	𝔠	
\mathfrakd	𝔡	
\mathfrake	𝔢	
\mathfrakf	𝔣	
\mathfrakg	𝔤	
\mathfrakh	𝔥	
\mathfraki	𝔦	
\mathfrakj	𝔧	
\mathfrakk	𝔨	
\mathfrakl	𝔩	
\mathfrakm	𝔪	
\mathfrakn	𝔫	
\mathfrako	𝔬	
\mathfrakp	𝔭	
\mathfrakq	𝔮	
\mathfrakr	𝔯	
\mathfraks	𝔰	
\mathfrakt	𝔱	
\mathfraku	𝔲	
\mathfrakv	𝔳	
\mathfrakw	𝔴	
\mathfrakx	𝔵	
\mathfraky	𝔶	
\mathfrakz	𝔷	
\mathbbA	𝔸	
\mathbbB	𝔹	
\mathbbD	𝔻	
\mathbbE	𝔼	
\mathbbF	𝔽	
\F	𝔽	
\mathbbG	𝔾	
\mathbbI	𝕀	
\I	𝕀	
\mathbbJ	𝕁	
\mathbbK	𝕂	
\K	𝕂	
\mathbbL	𝕃	
\mathbbM	𝕄	
\mathbbO	𝕆	
\mathbbS	𝕊	
\mathbbT	𝕋	
\mathbbU	𝕌	
\mathbbV	𝕍	
\mathbbW	𝕎	
\mathbbX	𝕏	
\mathbbY	𝕐	
\mathbba	𝕒	
\mathbbb	𝕓	
\mathbbc	𝕔	
\mathbbd	𝕕	
\mathbbe	𝕖	
\mathbbf	𝕗	
\mathbbg	𝕘	
\mathbbh	𝕙	
\mathbbi	𝕚	
\mathbbj	𝕛	
\mathbbk	𝕜	
\mathbbl	𝕝	
\mathbbm	𝕞	
\mathbbn	𝕟	
\mathbbo	𝕠	
\mathbbp	𝕡	
\mathbbq	𝕢	
\mathbbr	𝕣	
\mathbbs	𝕤	
\mathbbt	𝕥	
\mathbbu	𝕦	
\mathbbv	𝕧	
\mathbbw	𝕨	
\mathbbx	𝕩	
\mathbby	𝕪	
\mathbbz	𝕫	
\codeA	𝙰	
\monoA	𝙰	
\codeB	𝙱	
\monoB	𝙱	
\codeC	𝙲	
\monoC	𝙲	
\codeD	𝙳	
\monoD	𝙳	
\codeE	𝙴	
\monoE	𝙴	
\codeF	𝙵	
\monoF	𝙵	
\codeG	𝙶	
\monoG	𝙶	
\codeH	𝙷	
\monoH	𝙷	
\codeI	𝙸	
\monoI	𝙸	
\codeJ	𝙹	
\monoJ	𝙹	
\codeK	𝙺	
\monoK	𝙺	
\codeL	𝙻	
\monoL	𝙻	
\codeM	𝙼	
\monoM	𝙼	
\codeN	𝙽	
\monoN	𝙽	
\codeO	𝙾	
\monoO	𝙾	
\codeP	𝙿	
\monoP	𝙿	
\codeQ	𝚀	
\monoQ	𝚀	
\codeR	𝚁	
\monoR	𝚁	
\codeS	𝚂	
\monoS	𝚂	
\codeT	𝚃	
\monoT	𝚃	
\codeU	𝚄	
\monoU	𝚄	
\codeV	𝚅	
\monoV	𝚅	
\codeW	𝚆	
\monoW	𝚆	
\codeX	𝚇	
\monoX	𝚇	
\codeY	𝚈	
\monoY	𝚈	
\codeZ	𝚉	
\codea	𝚊	
\monoa	𝚊	
\codeb	𝚋	
\monob	𝚋	
\codec	𝚌	
\monoc	𝚌	
\coded	𝚍	
\monod	𝚍	
\codee	𝚎	
\monoe	𝚎	
\codef	𝚏	
\monof	𝚏	
\codeg	𝚐	
\monog	𝚐	
\codeh	𝚑	
\monoh	𝚑	
\codei	𝚒	
\monoi	𝚒	
\codej	𝚓	
\monoj	𝚓	
\codek	𝚔	
\monok	𝚔	
\codel	𝚕	
\monol	𝚕	
\codem	𝚖	
\monom	𝚖	
\coden	𝚗	
\monon	𝚗	
\codeo	𝚘	
\monoo	𝚘	
\codep	𝚙	
\monop	𝚙	
\codeq	𝚚	
\monoq	𝚚	
\coder	𝚛	
\monor	𝚛	
\codes	𝚜	
\monos	𝚜	
\codet	𝚝	
\monot	𝚝	
\codeu	𝚞	
\monou	𝚞	
\codev	𝚟	
\monov	𝚟	
\codew	𝚠	
\monow	𝚠	
\codex	𝚡	
\monox	𝚡	
\codey	𝚢	
\monoy	𝚢	
\codez	𝚣	
\monoz	𝚣	
\monoZ	𝚉	
\spadesuit	♠	
\heartsuit	♡	
\clubsuit	♣	
\diamondsuit	♢	
\varspadesuit	♤	
\varheartsuit	♥	
\varclubsuit	♧	
\vardiamondsuit	♦	
\par	¶	
\S	§	
\lrblacktriangle	◢	
\llblacktriangle	◣	
\ulblacktriangle	◤	
\urblacktriangle	◥	
\bigblacktriangledown	▼	
\bigblacktriangleup	▲	
\blacktriangle	▴	
\blacktriangledown	▾	
\blacktriangleleft	◀	
\blacktriangleright	▶	
\texttrademark	™	
\copyright	©	
\circledR	®	
_plus	₊	
^plus	⁺	
_minus	₋	
^minus	⁻	
_eq	₌	
^eq	⁼	
^lp	⁽	
^rp	⁾	
_lp	₍	
_rp	₎	
\hbar	ħ	
\hslash	ℏ	
\dagger	†	
\ddagger	‡	
\smalltilde	˜	
\aries	♈︎	
\taurus	♉︎	
\gemini	♊︎	
\cancer	♋︎	
\leo	♌︎	
\virgo	♍︎	
\libra	♎︎	
\scorpio	♏︎	
\sagittarius	♐︎	
\capricorn	♑︎	
\aquarius	♒︎	
\pisces	♓︎	
\sun	☉	
\moon	☾	
\mercury	☿	
\venus	♀	
\earth	⊕	
\mars	♂	
\ceres	⚳	
\jupiter	♃	
\saturn	♄	
\uranus	♅	
\neptune	♆	
\pluto	♇	
\frac12	½	
\frac13	⅓	
\frac23	⅔	
\frac14	¼	
\frac34	¾	
\frac15	⅕	
\frac25	⅖	
\frac35	⅗	
\frac45	⅘	
\frac16	⅙	
\frac56	⅚	
\frac18	⅛	
\frac38	⅜	
\frac58	⅝	
\frac78	⅞	
\co	℅	
\QED	∎	
\male	♂	
\female	♀	
\ohm	Ω	
\doublebarvee	⩢	
\doublebarwedge	⩞	
\perspcorrespond	⩞	
\daleth	ℸ	
^epsilon	ᵋ	
\rightangle	∟	
\rupee	₹	
\inr	₹	
\dollar	$	
\usd	$	
\euro	€	
\eur	€	
\yen	¥	
\jpy	¥	
\shekel	₪	
\sheqel	₪	
\ils	₪	
\nis	₪	
\ruble	₽	
\rub	₽	
\hryvnia	₴	
\uah	₴	
\lira	₺	
\try	₺	
\bitcoin	₿	
\btc	₿	
\dotsminusdots	∺	
\starequal	≛	
\triangleq	≜	
\cancela	a̷	
\cancelA	A̷	
\cancelb	b̷	
\cancelB	B̷	
\cancelc	c̷	
\cancelC	C̷	
\canceld	d̷	
\cancelD	D̷	
\cancele	e̷	
\cancelE	E̷	
\cancelf	f̷	
\cancelF	F̷	
\cancelg	g̷	
\cancelG	G̷	
\cancelh	h̷	
\cancelH	H̷	
\canceli	i̷	
\cancelI	I̷	
\cancelj	j̷	
\cancelJ	J̷	
\cancelk	k̷	
\cancelK	K̷	
\cancell	l̷	
\cancelL	L̷	
\cancelm	m̷	
\cancelM	M̷	
\canceln	n̷	
\cancelN	N̷	
\cancelo	o̷	
\cancelO	O̷	
\cancelp	p̷	
\cancelP	P̷	
\cancelq	q̷	
\cancelQ	Q̷	
\cancelr	r̷	
\cancelR	R̷	
\cancels	s̷	
\cancelS	S̷	
\cancelt	t̷	
\cancelT	T̷	
\cancelu	u̷	
\cancelU	U̷	
\cancelv	v̷	
\cancelV	V̷	
\cancelw	w̷	
\cancelW	W̷	
\cancelx	x̷	
\cancelX	X̷	
\cancely	y̷	
\cancelY	Y̷	
\cancelz	z̷	
\cancelZ	Z̷	
\cancel0	0̷	
\cancel1	1̷	
\cancel2	2̷	
\cancel3	3̷	
\cancel4	4̷	
\cancel5	5̷	
\cancel6	6̷	
\cancel7	7̷	
\cancel8	8̷	
\cancel9	9̷	
\models	⊧	
\nequiv	≢	
\VDash	⊫	
\Vdash	⊩	
\Vvdash	⊪	
\nvdash	⊬	
\vDash	⊨	
\nvDash	⊭	
\swastika	卐	
\revSwastika	卍	
\imath	𝚤	
i	𝚤	
\mathbb0	𝟘	
\0	𝟘	
\mathbb1	𝟙	
\1	𝟙	
\mathbb2	𝟚	
\mathbb3	𝟛	
\mathbb4	𝟜	
\mathbb5	𝟝	
\mathbb6	𝟞	
\mathbb7	𝟟	
\mathbb8	𝟠	
\mathbb9	𝟡	
_Q	🇶	
LLAP	🖖🏻	
